WWWWWWWWWWWWWWWWWWWWWWWWW
WPPPPPPPPPPPPPPWWWWWWPWWW
WPWWWPWWWWWWWWPWWWWWPPWWW
WPPWWPPPPWWWWWPPPPPPPWWWW
WWPPWWWWPWWWWWWWWPWWWWWWW
WWWPWWWWPPPPPPWWWPWWWWWWW
WWWPPPPPPPWWWPWWWPPPPPWWW
WWWPWWWWWPWWWPWWWWWWWPWWW
WWWPWWWWWPPPPPPPPPWWWPWWW
WWWPWWWWWPWWWWWWWPWWWPWWW
WWPPPPWWWPWWWPWWWPWWWPPPW
WWPWWPWWWPWWWPWWWPWWWWWWW
WWPWWPWWWPWWWPPPWPWWWWWPW
WWPWWPPPPPWWWWWPWPWWWWWPW
WWPWWPWWWWWWWWWPWPPPPPPPW
WWPWWPWWWWWWWWWPWPWWWWWWW
WWPWWPWPPPPPWWWPPPPWWWWWW
WWPWWPWWWWWPWWWWWWPWWWWWW
WWPPPPPPPPPPWWWWWWPPPPPWW
WWWWWPWWWWWWWWWPPPPWWWWWW
WWPPPPWWWWWWWWWPWWWPWWWPE
WWPWWWWWWPPPWWWPWWWPPPWPW
WWPWWPWWWPWPPPPPWWWWWWWPW
WWWWWPPPPPWWWWWPPPPPPPPPW
WWWWWWWWWWWWWWWWWWWWWWWWW