WWWWWWWWWWWWWWWWWWWWWWWWW
WPPPPPWWWWWWWWWWWWWWWWWWW
WWWWWPWWWWWWWWWWWWWWWWWWW
WWWWWPPPPWWWWWWWWWWWWWWWW
WWWWWWWWPWWWWWWWWWWWWWWWW
WWWWWPPPPPWWWWWWWWWWWWWWW
WWWWWPWWWPWWWWWWWWWWWWWWW
WWWWWPWWWPWWWWWWWWWWWWWWW
WWWWWPWWWPPPPPWWWWWWWWWWW
WWWWWPWWWWWWWPWWWWWWWWWWW
WWWWWPWWWWWWWPWWWWWWWWWWW
WWWWWPWWWWWWWPWWWWWWWWWWW
WWWWWPWWWWWWWPPPWWWWWWWWW
WWWWWPWWWWWWWWWPWWWWWWWWW
WWWWWPPPPPWWWWWPWWWWWWWWW
WWWWWWWWWPWWWWWPWWWWWWWWW
WWWWWWWWWPWWWWWPPPPWWWWWW
WWWWWWWWWPWWWWWWWWPWWWWWW
WWWWWWWWWPPPPPPPPPPWWWWWW
WWWWWWWWWWWWWWWWWWPWWWWWW
WWWWWWWWWWWWWWWWWWPPPPPPE
WWWWWWWWWWWWWWWWWWWWWWWWW
WWWWWWWWWWWWWWWWWWWWWWWWW
WWWWWWWWWWWWWWWWWWWWWWWWW
WWWWWWWWWWWWWWWWWWWWWWWWW