WWWWWWWWWWWWWWWWWWWWWWWWW
WPPPPPPPPPPPPPPWWWWWWPWWW
WPWWWPWWWWWWWWPWWWWWPPWWW
WPPWWPPPPWWWWWPPPPPPPWWWW
WWPPWWWWPWWWWWWWWPWWWWWWW
WWWPWWWWPWWWWWWWWPWWWWWWW
WWWPPPPPPPWWWWWWWPPPPPWWW
WWWPWWWWWPWWWWWWWWWWWPWWW
WWWPWWWWWPPPPPPPPPWWWPWWW
WWWPWWWWWPWWWWWWWPWWWPWWW
WWPPPPWWWPWWWPWWWPWWWPPPW
WWPWWPWWWPWWWPWWWPWWWWWPW
WWPWWPWWWPWWWPPPWPWWWWWPW
WWPWWPPPPPWWWWWPWPWWWWWPW
WWPWWPWWWWWWWWWPWPPPPPPPW
WWPWWPWWWWWWWWWPWPWWWWWWW
WWPWWPWPPPPPWWWPPPPWWWWWW
WWPWWPWWWWWPWWWWWWPWWWWWW
WWPPPPPPPPPPWWWWWWPPPPPPW
WWWWWPWWWWWWWWWPPPPWWWWPW
WWPPPPWWWWWWWWWPWWPPWWWPW
WWPWWWWWWPPPWWWPWWWPPPWPW
WWPWWPWWWPWPPPPPWWWWWPPWW
WWWWWPPPPPWWWWWPPPPPPWPPW
WWWWWWWWWWWWWWWWWWWWWWWEW