WWWWWWWWWWWWWWWWWWWWWWWWW
WPPPPPPPPPWWWWWWWWWWWWWWW
WWWWWPWWWPWWWWWWWWWWWWWWW
WWWWWPWWWPWWWWWWWWWWWWWWW
WWWWWPWWWPWWWWWWWWWWWWWWW
WWWWWPWWWPWWWWWWWWWWWWWWW
WWWWWPPPP<PPPPPPPPPWWWWWW
WWWWWPWWWPWWWWWWWWPWWWWWW
WWWWWPWWWPPPPWWWWWPWWWWWW
WWWWWPWWWWWWWPWWWWPWWWWWW
WWWWWPWWWWWWWPWWWWPWWWWWW
WWWWWPWWWWWWWPWWWWPWWWWWW
WWWWWPWWWWWWWPPPWWPWWWWWW
WWWWWPWWWWWWWWWPWWPWWWWWW
WWWWWPPPPPWWWWWPWWPWWWWWW
WWWWWWWWWPWWWWWPWWPWWWWWW
WWWWWWWWWPWWWWWPPPPWWWWWW
WWWWWWWWWPWWWWWWWWPWWWWWW
WWWWWWWWWPPPPPPPPPPWWWWWW
WWWWWWWWWWWWWWWWWWPWWWWWW
WWWWWWWWWWWWWWWWWWPPPPPPE
WWWWWWWWWWWWWWWWWWWWWWWWW
WWWWWWWWWWWWWWWWWWWWWWWWW
WWWWWWWWWWWWWWWWWWWWWWWWW
WWWWWWWWWWWWWWWWWWWWWWWWW