WWWWWWWWWWWWWWWWWWWWWWWWW
WPPPPPPPPWPPPPPPPPPPPWWWW
WPWWWWWWPWPWPWWWWWWWPWWWW
WPWPPPPPWWPWPWPPPPPWPPPWW
WPWPWWWPWPPWPWPWWWPWWWPWW
WPWPPPWPWPWWPWPWWWPPPPPWW
WPWWWPWPW<WWPWPWWWWWPWWWW
WPPPPPWPWPWWPWPWWWWWPPPPW
WWWWWWWPWPWWPWPPPPPPWWWPW
WWPPPPPPWPPWPWPWWWWPWWPPW
WWPWWWWWPWPWPWPWWWWPWWPWW
WWPPPPPPPWPWPWPWPPPPWWPWW
WWPWWWWPWWPPPWPWPWWWWWPWW
WWPWWWWWWWPWWWWWPWWWPPPWW
WPPPPPPPPPPWWWPPPWWWPWWWW
WPWWWWPWWWWWWWPWWPWWPWWWW
WPPPPWPWPPPPPPPWPPPPPPPPW
WWWWWPPWPWWWWWWWWWWWWWWPW
WPPPPPWWPWWPPPEWPPPPPPWPW
WPWWWWWWPWWPWWWPPWWWWPWPW
WPWPPPPPPWWPPPPPWWPPPPWPW
WPWPWWWWWWWWWWWWPPPWWWWPW
WPWPWWWWPPPPWWPPPWWPPPPPW
WWWPPPPPPWWPPPPWWPPPWWWWW
WWWWWWWWWWWWWWWWWWWWWWWWW