WWWWWWWWWWWWWWWWWWWWWWWWW
WPPPPPPPPPPPPPPWWWWWWPWWW
WPWWWPWWWWWWWWPWWWWWPPWWW
WPPWWPPPPWWWWWPPPPPPPWWWW
WWPPWWWWPPPPPWWWWPWWWWWWW
WWWPWWWWPWWWWWWWWPWWWWWWW
WWWPPPPPPPWWWWWWWPPPPPWWW
WWWPWWWWWPWWWWWWWWWWWPWWW
WWWPWWWWWPPPPPPPPPWWWPWWW
WWWPWWWWWPWWWWWWWPWWWPWWW
WWPPPPWWWPWPPPWWWPWWWPPPW
WWPWWPWWWPWPWPWWWPWWWWWPW
WWPWWPWWWPWPWPPPWPWWWWWPW
WWPWWPPPPPWPWWWPWPWWWWWPW
WWPWWPWWWWWPWWWPWPWPPPPPW
WWPWWPWWWWWPWWWPWPWWWWWWW
WWPWWPWPPPPPWWWPPPPWWWWWW
WWPWWPWWWWWPWWWWWWPWWWWWW
WWPPPWPPPPPPWWWWWWPPPPPPW
WWWWWPWWWWWPWWWPPPPWWWWPW
WWPPPPWWWWWPWWWPWWPPWWWPW
WWWWWWWWWPPPWWWWWWWPPPWPW
EPPPPPWWWPWPPPPPWWWWWWWPW
WWWWWPPPPPWWWWWPPPPPPPPWW
WWWWWWWWWWWWWWWWWWWWWWWWW